#####
# ..#
#*.R#
#\..#
#\#.#
#####
