#####
#...#
#*.R#
#\..#
#\#.#
#####