########
#R.A#.\#
#...#..#
#####1.#
########
