########
#R.A#..#
#...#..#
#####1.#
########